# # # . # . # # # #
# # . # . . # # # #
# . * * * * # # # #
# # # # # # # # # #
# # * * * * * * # #
# . # . . # . # . #
# # . # # . # . # #
# # # # # # # # # #